--------------------------------------------------------------------------------------------------------------------------------------------------------------------------------------------------------
--------------------------------------------------------------------------------------------------------------------------------------------------------------------------------------------------------
-oo-oo-------o-oo-?oo---o---------?----o-o-o-o----oo-----?o--?o?o-o--Bo---o------------o----?o--------o-o----?-ooo-oo-----o---oo-o--o-o?o-o-o-o-o-oM-?-o?oo-o--o?------?-o--o---o-----o-o?----o-oo------
------?ooo?-oo-oo-oo---o--ooo------o-o-ooo-o-----oo-Booooo--?-o--o--o----oo------???----?oooo-o-----o--o----?-o--o-oo-o--o----o?-oo?--o-o-o-?--o----o?---o-o?--o----o---o-o------o----------o?------?---
----o--o-o---o?--oo?---?-o---o?ooo?--?------o----o-o?-o---oo?--o--o--oo-----o?----o--o----?--oo----o----oo-?--oo-o----Bo-o-----o----o------o?-ooo---------ooo--o----o---o-oo--oo--ooo----?--o-------?o--
---?o?--o-oo--o?--o--oo---?o----o---oo-o--?oo?o-?-o-?---------------o-o----o-o-oo-oo-o------?--oo--o?oo-oo--o----oo?o-o-----?--oo-oo-o------o-?--?o--?o-?--E?ooo---o--ooo----o?-o---oo-o??o-o--o?-------
-oo---o--?-----?-o----oo-o-ooo-o-----o-------?-?oo-o-ooo-o-o?-o--oo-o-oo-?--o-oo-o--o--o-----o-oo-o------o----oo---o------o--o---o-o--o-??-----oo---o--o------o-o----ooo--o--?--?-----o-oo--?--o-----?--
--o--oo-?-----o-??-----o?----?-?oooo?-oo----?--?--o-----?-oo--oo---o----o-?--?---ooo--?-o------o-oo-o--------ooo----o-------------?---------oo--ooM--o-----o-o-ooo--o--oo--o?o-o----oo-o--?--o-o?o--oo-v
-o--?ooo---o-?oo---o--o-o?-?-oo---o-o--o---o-----?---o-?-o-o-----o----o??-----o-o--?--o--o----oo-----?---o--------o--o-----------o-----?----o-?---o--oo-?o--o--?o---o-ooo--o--oo-??oo-o--o----o--------f
--?-o-oo-----------?o---E-------------------o------------o-------o---ooo--o-ooo------o-o--oo--o----o--o?--oo--?--ooo-o--?-o------?o--o-o-o--o-ooo--?o-oo----?--o--oo-------o---?oo--o-o-oo-o--o-oooooo-f
-?-o-o---?-o?----oo----?o-o?-oo-?-o---o-oo-o---o-?------?o???-oo-??--oo-o-----------o-o--o----o----------M-?--o---o--o--Bo?-----o-?-?o-?---oo?-oo-oo----------?o-?--?o--?-?-----------oo----o?---o-----f
--?o------?o-?--------?----o---oo---?-oooo?----o---?o-----o?--o-----oo--o---o-?-o--o----oo---o-oo----?---o?--o-o-o---o--o-o---oo-o--o?o-?o-o?---o-----oo?-o-?---o---o----ooooooB-?----o-o-o-?o-o----oo-f
-o-?-?--o---o--o--o-o------o-------o-o--o-o------------?-oo--?-o---ooo-------?--?--o-----ooo?oo----o---o--ooo----o-o-----?o---o--o-o-oo--oo--o----o-oooo-o-o--o-o?-oo---o--o?--oM??o---?-----o----o--o-f
-?-o-o-oo-o---?--o-o---o-o--o-----o--oo-?-o----o--oE-?--o--o-?------ooo-o-o??-?oo-o----o-o---oo-o?---o-o-o--o--o--------oo------oo?o----o--?-o-o?-------o--o-o----?-o-----o?--oo---?---oo----o---o-o---f
m-ooo-oo?-------oo-o?o?o-oo-----?-o---?o------o----o--o-oo----------------oo?o-o---oo--o-----o--o----o--?-o---o--o--o?----o--?o-o--o--oo---oo-o-?-o-o--o--o--ooo------------o-?oo------o-o------o----ooX
X---XXXB-XXXBXBXBBX-XXBB-BX-XXBBX--X-XXB--X-X-X-XX-BoBX--XX-X-XXXXBB-XXXX--BXXoX-X-XXX--XXXBXBXXXBXX--XXXX-XB--BXB---XBX-o--BX--B-B-X---BXB--XBXXXBBXX-BXXXXXXXX---BB--BBBX-BXBXBXXoXoB-oXXXBBXX-XX-X--X
