XXXXXXXXXXXXXXXXXXXXXX
X1231X1123321c1321Xe2X
X3221X213211XXXXXXX21X
X13a2XXXXXXXXX1322123X
X2222132132111XXXXXXXX
X21331211XXXXXX1322b1X
XXXXXXX13322211223XXXX
X221322212XXXXXXXXXXXX
XXXXX2211233321323221X
XXXXXXXX2331121321323X
XXXXXXXXXX2d133XXXXXXX
XXXXXXXXXXXXXXXXXXXXXX